....p......
....###3###
#*###.....#
.#........2
.######.1..
....#...#..
....#*###..